mdeoowcydm	male
onhfupgknn	male
krakbvleec	male
rfvxjmlskp	male
mxdogijvix	female
ygykhvgngv	unknown
abkcqttjop	unknown
cctzwolvby	male
bhjbqgfzrt	male
dmtawerhdg	unknown
rjkudgjrpm	male
vthpsqjayl	unknown
naanywwivx	male
ncvzvsgpti	unknown
jundbnothq	unknown
lcglgfaohb	male
kjqjtlldeo	male
ohbdteoaca	unknown
qwbqvbkkxb	unknown
yenikpxjxx	male
jmsrpfrijp	unknown
jfecosuifm	female
jxfieivjeq	unknown
zamaceqoez	unknown
xtdjrhsvdm	male
mhfakxanwo	unknown
ggvsfqlyej	unknown
ssfagjwqmo	unknown
zoayukjita	unknown
tzhmhkxuof	male
vstrhzigua	male
dhsyeskdio	male
nqwmvyimpr	unknown
iixvnknkmp	unknown
cudizmldwx	unknown
tdzafgprvj	male
qtaxmfmuuj	unknown
krnbvwdioo	male
adqlmyjoii	unknown
jwnolmdwxf	unknown
aqshvlnqfq	male
jmolfjckrd	male
cxfvwywfyf	unknown
hquuqxoxra	unknown
gixhskrllz	male
kvkznhaovd	male
tiaaiizwpk	unknown
bdqdbvdifr	unknown
anzizizmju	unknown
jihbpfvzec	unknown
umfnganjvn	male
dgofzrxscw	male
dcgxrnbtfi	unknown
dblretuyya	female
mzzbvesdww	unknown
fyogpiuokd	unknown
sshpressak	male
inrqhwwmtz	unknown
xidrkfpevw	male
htpekokluo	unknown
ppudbarfyr	male
gubcponknm	unknown
cvzclpuzgx	unknown
nowwpoyzqg	unknown
kzbiyrpfjx	unknown
pudnremyrc	male
iajtlcswrm	unknown
jiuinavpzr	unknown
xmpudltmsh	male
puaosdfpsh	male
xvuwohqnce	unknown
fpcpfurktw	male
soaicvboqu	unknown
rsmqijrcsi	unknown
hacjtcuzut	male
hmziobsoie	unknown
skgbjdapol	male
nzcwkeojqo	unknown
dxuchxwucs	unknown
nbdtlnqcqg	male
imychjkbju	male
uyfrflablj	unknown
ftcxmoigjx	unknown
ufpolzyjvq	unknown
dhuticihya	male
ebgzhrqysw	male
msccnltexx	unknown
zjfustrmkc	male
usjroytwyq	unknown
acwortflow	unknown
fnklizsziv	unknown
yicaedsbvx	male
tfcaufykex	unknown
xuefluamsf	male
tdbqbqjcsj	unknown
bgbkfcejyi	unknown
nyfdbmdxii	unknown
dzopcqpkyd	male
kiubvpzmuz	female
ukruiduszu	female
vvjqxvwsbr	male
glkouaeuvn	unknown
yfopgnkoaf	unknown
jvsuzdxjol	unknown
meqcfefubo	male
eufradtute	male
dxnmuhoroc	male
ytiyavacqe	unknown
fjesoulufx	male
brcktstfek	unknown
gapzegeafd	female
kkeutrjqhd	male
nqelinufuu	male
kkvygmaioo	unknown
pecvbdflpn	unknown
nqtveuncuz	male
vibpmohjau	unknown
mhraamrwzn	unknown
xrkdiozrzc	unknown
sesisrzxzf	unknown
mqrcxsakny	male
waeoaiqfnj	unknown
xdtibwvdht	unknown
bzdkckhaxm	unknown
nxwoplfotr	unknown
akpcitcarf	male
ircnjcpdjy	male
